LT202_GBP2_Donor_FW	aggtgaaaaaaattgaaaaaaaatgaaagcttggatgaaatcaattatatTAACTAGCTGAttatggtggttgtagtttacagatctcttatgctagacgtgattaattcc
LT202_GBP2_Donor_RV	ggaattaatcacgtctagcataagagatctgtaaactacaaccaccataaTCAGCTAGTTAatataattgatttcatccaagctttcattttttttcaatttttttcacct
LT203_RPS14A_Donor_FW	gcttcctcaggtagacagttgaaatgaattggttattaatcactatatatTAACTAGCTGAagactccaccagaaagaagggtggtagaagaggtagaagattatgagtta
LT203_RPS14A_Donor_RV	taactcataatcttctacctcttctaccacccttctttctggtggagtctTCAGCTAGTTAatatatagtgattaataaccaattcatttcaactgtctacctgaggaagc
LT204_HCM1_Donor_FW	attctattcttttccccccttttattatagttacatctactatttgagctTAACTAGCTGAttatcataatcacccttccaacgatagcggtaatgaaaagaattgacttt
LT204_HCM1_Donor_RV	aaagtcaattcttttcattaccgctatcgttggaagggtgattatgataaTCAGCTAGTTAagctcaaatagtagatgtaactataataaaaggggggaaaagaatagaat
LT205_MSH3_Donor_FW	acgtgaattttcaatgataaataagctggaacaatggtgataggtaatgaTAACTAGCTGAagcaacggataaactcgcgaaattactatcattggatatccactgatgcg
LT205_MSH3_Donor_RV	cgcatcagtggatatccaatgatagtaatttcgcgagtttatccgttgctTCAGCTAGTTAtcattacctatcaccattgttccagcttatttatcattgaaaattcacgt
LT206_OCA4_Donor_FW	agttttctagcattaaatggacagtaaggtaaagaaatgagatgtggttgTAACTAGCTGAcgttccggaagagcatcacttttatagggaacatatttttacatagttta
LT206_OCA4_Donor_RV	taaactatgtaaaaatatgttccctataaaagtgatgctcttccggaacgTCAGCTAGTTAcaaccacatctcatttctttaccttactgtccatttaatgctagaaaact
LT207_WWM1_Donor_FW	cgagccggcagctggaagaaaaagtttactttagtcatgataatcaaaagTAACTAGCTGAgttcgacggcggatttgatgatggatttgacggtggtgacttttaatgtt
LT207_WWM1_Donor_RV	aacattaaaagtcaccaccgtcaaatccatcatcaaatccgccgtcgaacTCAGCTAGTTActtttgattatcatgactaaagtaaactttttcttccagctgccggctcg
LT208_MRP13_Donor_FW	gaacactttgtcaatgtatttagttgtattcatacccaatttattggcacTAACTAGCTGAggaaacaccacctcctcaggaatccaccgaaaaagaggaaaaatagtacc
LT208_MRP13_Donor_RV	ggtactatttttcctctttttcggtggattcctgaggaggtggtgtttccTCAGCTAGTTAgtgccaataaattgggtatgaatacaactaaatacattgacaaagtgttc
LT209_TIR3_Donor_FW	tggagagtataagcgtttcgtctcctcttcctttctctactgcagattttTAACTAGCTGAtggtgttggtgccgctattgccggtgccgctgctatgctcttatgattgt
LT209_TIR3_Donor_RV	acaatcataagagcatagcagcggcaccggcaatagcggcaccaacaccaTCAGCTAGTTAaaaatctgcagtagagaaaggaagaggagacgaaacgcttatactctcca
LT210_QDR1_Donor_FW	gcaatcagcgttcaaaggaacttattcttgcttaaaaaaagtgataatctTAACTAGCTGAggctggaaggtcagttggtaaaaattcagaaaaagtttcgacgtgaagaa
LT210_QDR1_Donor_RV	ttcttcacgtcgaaactttttctgaatttttaccaactgaccttccagccTCAGCTAGTTAagattatcactttttttaagcaagaataagttcctttgaacgctgattgc
LT211_MET28_Donor_FW	gttgtaggtcactggcgtgagtcaaggccgggcagccaatgactaagaacTAACTAGCTGAtttgaaattgttgaatgacattaagagacggaacatgggcaggtagcccg
LT211_MET28_Donor_RV	cgggctacctgcccatgttccgtctcttaatgtcattcaacaatttcaaaTCAGCTAGTTAgttcttagtcattggctgcccggccttgactcacgccagtgacctacaac
LT212_RPS14B_Donor_FW	aagatatagtcgcaagaacttgccttctacgagtataaaagcggtactatTAACTAGCTGAagactccaccagaaagaagggtggtagaagaggtagaagattatgatttc
LT212_RPS14B_Donor_RV	gaaatcataatcttctacctcttctaccacccttctttctggtggagtctTCAGCTAGTTAatagtaccgcttttatactcgtagaaggcaagttcttgcgactatatctt
LT213_SMA2_Donor_FW	ataccatgcacttacttaaattctatgaacacatccatcaattaaaagatTAACTAGCTGAagaagacacatctaactccccttctccagacttgatggagaagtaattca
LT213_SMA2_Donor_RV	tgaattacttctccatcaagtctggagaaggggagttagatgtgtcttctTCAGCTAGTTAatcttttaattgatggatgtgttcatagaatttaagtaagtgcatggtat
LT214_HLJ1_Donor_FW	gtgaagaacataaaggaagctggcagaagttcttttcatacacctctactTAACTAGCTGAcatctttattgttcttcctatgattaaagattacctgtttagttaaacac
LT214_HLJ1_Donor_RV	gtgtttaactaaacaggtaatctttaatcataggaagaacaataaagatgTCAGCTAGTTAagtagaggtgtatgaaaagaacttctgccagcttcctttatgttcttcac
LT215_BCH1_Donor_FW	cgataatgtagtaacaaatggacccttaaacatctcaattcatcttcttgTAACTAGCTGAtctaaattttctgaagaatttcacgaatgacactttcgataattagaaaa
LT215_BCH1_Donor_RV	ttttctaattatcgaaagtgtcattcgtgaaattcttcagaaaatttagaTCAGCTAGTTAcaagaagatgaattgagatgtttaagggtccatttgttactacattatcg
LT216_AIF1_Donor_FW	gctgctgcagactagaaacgaaagcagtgataaatcattgatagacacacTAACTAGCTGAgaagaatcttttctccgacaaaatggaacctttattcaaaaaatagacta
LT216_AIF1_Donor_RV	tagtctattttttgaataaaggttccattttgtcggagaaaagattcttcTCAGCTAGTTAgtgtgtctatcaatgatttatcactgctttcgtttctagtctgcagcagc
LT217_FRT1_Donor_FW	agcctatttatttattgatctgggtcggatagttcaccctatttgtggagTAACTAGCTGAtatcgtttacgtcaagaatttgttaactcgtttttttactcgttaaaaag
LT217_FRT1_Donor_RV	ctttttaacgagtaaaaaaacgagttaacaaattcttgacgtaaacgataTCAGCTAGTTActccacaaatagggtgaactatccgacccagatcaataaataaataggct
	